NO xpms/wall8_64.xpm
SO xpms/wall8_64.xpm
WE xpms/wall8_64.xpm
EA xpms/wall8_64.xpm


F 255,182,193
C 255,215,225


11111111111111111111
1W000000010000000041
10111110010111111011
10120010010100001011
10111010000101101001
100000111D1101501101
11110110000001100001
10000100111101111011
10111101100000001001
10100001001111011011
10103001011000001011
10111111010011101001
10000000010114001101
11111111010111101001
10000000010000101051
10111111111101101111
10100000000100000001
10103011110101111101
10000012000001000021
11111111111111111111
