NO xpms/wall8_64.xpm
SO xpms/wall8_64.xpm
WE xpms/wall8_64.xpm
EA xpms/wall8_64.xpm


F 255,182,193
C 255,215,225


11111111111111111111
10200000000111100401
100001110W0002000001
11110111100000001111
10000100111111000001
10000300100001040001
11111110101101000101
10000000101101000101
10002000101101111101
1011111010D000000101
10000000101111100001
10005000100000100201
10000000111110101111
11111110000010100001
10000010003000101101
10000010100000100001
10111110101111111001
10000000100000000001
10301111111111111051
11111111111111111111
