NO xpms/wall8_64.xpm
SO xpms/wall8_64.xpm
WE xpms/wall8_64.xpm
EA xpms/wall8_64.xpm


F 255, 185, 193
C 255,215,225



11111111111
10020010001
11101110101
10000510301
11D11110101
130000W0101
10001111101
10411020101
10000000001
11111111111

