NO xpms/wall8_64.xpm
SO xpms/wall8_64.xpm
WE xpms/wall8_64.xpm
EA xpms/wall8_64.xpm


F 255,182,193
C 255,215,225



11111111111
10020010001
11101110101
10000010101
11D11110101
100000W0101
10001111101
10211000101
10000210001
11111111111

