NO xpms/wall8_64.xpm
SO xpms/wall8_64.xpm
WE xpms/wall8_64.xpm
EA xpms/wall8_64.xpm


F 255,182,193
C 255,215,225


111111111111
100000100001
111011101001
100000101001
11D110101001
100W02001001
100011111001
100110001001
100000100001
111111111111

