NO xpms/wall8_64.xpm
SO xpms/wall8_64.xpm
WE xpms/wall8_64.xpm
EA xpms/wall8_64.xpm


F 255,182,193
C 255,215,225


11111111111
10000010001
11101110101
10000010101
11111010101
100W0200101
10101111101
10111000101
10000010001
11111111111

