NO            xpms/wall8_64.xpm
SO																		 xpms/wall8_64.xpm
WE                 xpms/wall8_64.xpm
EA xpms/wall8_64.xpm


F 255,   182,    193

C 255,215,225





111111111111 00
111111111111
111100001111
  111N11111
    1111