

F 255,182,193
C 255,215,225


NO xpms/wall8_64.xpm
SO xpms/wall8_64.xpm


WE xpms/wall8_64.xpm
EA xpms/wall8_64.xpm


1111111111111    
10020010000001
11101110101111111
1000051030101
11D11110101
1300001W1111
10001111111  
10001111111   
10001111111   	
10411020101  
10000000001   
11111111111

    

