

F 255,182,193
C 255,215,225


NO xpms/wall8_64.xpm
SO xpms/wall8_64.xpm


WE xpms/wall8_64.xpm
EA xpms/wall8_64.xpm


11111111111   
12000010001
11101110101
10000510301
11D11110101
1300000W111
10001111111  
10001111111   
10001111111   	
10411020101  
10000000001   
11111111111

    

